HAIR,FEATHERS,EGGS,MILK,AIRBORNE,AQUATIC,PREDATOR,TOOTHED,BACKBONE,BREATHES,VENOMOUS,FINS,LEGS,TAIL,DOMESTIC,CATSIZE
1, 0, 0, 1, 0, 0, 1, 1, 1, 1, 0, 0, 4, 0, 0, 1, 1
0, 0, 1, 0, 0, 1, 1, 1, 1, 0, 0, 1, 0, 1, 0, 0, 4
0, 1, 1, 0, 1, 1, 0, 0, 1, 1, 0, 0, 2, 1, 0, 0, 2
0, 0, 1, 0, 0, 1, 1, 1, 1, 1, 1, 0, 4, 0, 0, 0, 5
1, 0, 0, 1, 0, 0, 0, 1, 1, 1, 0, 0, 4, 1, 0, 1, 1
1, 0, 0, 1, 0, 0, 0, 1, 1, 1, 0, 0, 2, 0, 0, 1, 1
0, 1, 1, 0, 1, 0, 1, 0, 1, 1, 0, 0, 2, 1, 0, 0, 2
1, 0, 1, 0, 1, 0, 0, 0, 0, 1, 0, 0, 6, 0, 0, 0, 6
1, 0, 0, 1, 0, 0, 1, 1, 1, 1, 0, 0, 4, 1, 0, 1, 1
0, 0, 1, 0, 0, 1, 1, 0, 0, 0, 0, 0, 5, 0, 0, 0, 7
1, 0, 0, 1, 0, 0, 1, 1, 1, 1, 0, 0, 4, 0, 0, 1, 1
1, 0, 0, 1, 0, 0, 0, 1, 1, 1, 0, 0, 4, 1, 0, 1, 1
0, 0, 1, 0, 0, 1, 1, 1, 1, 0, 0, 1, 0, 1, 0, 0, 4
1, 0, 0, 1, 0, 0, 1, 1, 1, 1, 0, 0, 4, 1, 0, 1, 1
1, 0, 0, 1, 0, 0, 0, 1, 1, 1, 0, 0, 4, 1, 0, 1, 1
1, 0, 0, 1, 0, 0, 0, 1, 1, 1, 0, 0, 4, 1, 1, 1, 1
0, 0, 1, 0, 0, 1, 0, 1, 1, 0, 0, 1, 0, 1, 1, 0, 4
1, 0, 0, 1, 0, 0, 0, 1, 1, 1, 0, 0, 4, 0, 1, 0, 1
1, 0, 0, 1, 0, 0, 1, 1, 1, 1, 0, 0, 4, 1, 0, 1, 1
0, 1, 1, 0, 1, 0, 0, 0, 1, 1, 0, 0, 2, 1, 1, 0, 2
0, 0, 1, 0, 0, 1, 1, 1, 1, 0, 0, 1, 0, 1, 0, 0, 4
0, 0, 1, 0, 0, 0, 1, 0, 0, 0, 0, 0, 0, 0, 0, 0, 7
0, 0, 1, 0, 0, 1, 1, 0, 0, 0, 0, 0, 4, 0, 0, 0, 7
0, 0, 1, 0, 0, 1, 1, 0, 0, 0, 0, 0, 6, 0, 0, 0, 7
0, 1, 1, 0, 1, 0, 1, 0, 1, 1, 0, 0, 2, 1, 0, 0, 2
1, 0, 0, 1, 0, 0, 0, 1, 1, 1, 0, 0, 4, 1, 0, 1, 1
0, 0, 1, 0, 0, 1, 1, 1, 1, 0, 0, 1, 0, 1, 0, 1, 4
0, 0, 0, 1, 0, 1, 1, 1, 1, 1, 0, 1, 0, 1, 0, 1, 1
0, 1, 1, 0, 1, 0, 0, 0, 1, 1, 0, 0, 2, 1, 1, 0, 2
1, 0, 0, 1, 0, 0, 0, 1, 1, 1, 0, 0, 4, 1, 0, 1, 1
0, 1, 1, 0, 1, 0, 0, 0, 1, 1, 0, 0, 2, 1, 0, 1, 2
0, 0, 1, 0, 0, 0, 0, 0, 0, 1, 0, 0, 6, 0, 0, 0, 6
0, 0, 1, 0, 0, 1, 1, 1, 1, 1, 0, 0, 4, 0, 0, 0, 5
1, 0, 0, 1, 1, 0, 0, 1, 1, 1, 0, 0, 2, 1, 0, 0, 1
1, 0, 0, 1, 0, 0, 1, 1, 1, 1, 0, 0, 2, 0, 1, 1, 1
0, 0, 1, 0, 1, 0, 0, 0, 0, 1, 0, 0, 6, 0, 0, 0, 6
1, 0, 0, 1, 0, 0, 0, 1, 1, 1, 0, 0, 4, 1, 1, 1, 1
0, 1, 1, 0, 1, 1, 1, 0, 1, 1, 0, 0, 2, 1, 0, 0, 2
0, 0, 1, 0, 0, 1, 0, 1, 1, 0, 0, 1, 0, 1, 0, 0, 4
1, 0, 0, 1, 0, 0, 0, 1, 1, 1, 0, 0, 4, 1, 1, 0, 1
1, 0, 0, 1, 0, 0, 0, 1, 1, 1, 0, 0, 4, 1, 0, 0, 1
0, 0, 1, 0, 0, 1, 1, 1, 1, 0, 0, 1, 0, 1, 0, 0, 4
1, 0, 1, 0, 1, 0, 0, 0, 0, 1, 1, 0, 6, 0, 1, 0, 6
0, 1, 1, 0, 0, 0, 1, 0, 1, 1, 0, 0, 2, 1, 0, 0, 2
0, 0, 1, 0, 1, 0, 1, 0, 0, 1, 0, 0, 6, 0, 0, 0, 6
0, 1, 1, 0, 1, 0, 0, 0, 1, 1, 0, 0, 2, 1, 0, 0, 2
1, 0, 0, 1, 0, 0, 1, 1, 1, 1, 0, 0, 4, 1, 0, 1, 1
1, 0, 0, 1, 0, 0, 1, 1, 1, 1, 0, 0, 4, 1, 0, 1, 1
0, 0, 1, 0, 0, 1, 1, 0, 0, 0, 0, 0, 6, 0, 0, 0, 7
1, 0, 0, 1, 0, 1, 1, 1, 1, 1, 0, 0, 4, 1, 0, 1, 1
1, 0, 0, 1, 0, 0, 1, 1, 1, 1, 0, 0, 4, 1, 0, 0, 1
1, 0, 0, 1, 0, 0, 1, 1, 1, 1, 0, 0, 4, 1, 0, 1, 1
1, 0, 1, 0, 1, 0, 0, 0, 0, 1, 0, 0, 6, 0, 0, 0, 6
0, 0, 1, 0, 0, 1, 1, 1, 1, 1, 0, 0, 4, 1, 0, 0, 5
0, 0, 1, 0, 0, 1, 1, 0, 0, 0, 0, 0, 8, 0, 0, 1, 7
1, 0, 0, 1, 0, 0, 1, 1, 1, 1, 0, 0, 4, 1, 0, 0, 1
1, 0, 0, 1, 0, 0, 0, 1, 1, 1, 0, 0, 4, 1, 0, 1, 1
0, 1, 1, 0, 0, 0, 0, 0, 1, 1, 0, 0, 2, 1, 0, 1, 2
0, 1, 1, 0, 1, 0, 0, 0, 1, 1, 0, 0, 2, 1, 1, 0, 2
0, 1, 1, 0, 0, 1, 1, 0, 1, 1, 0, 0, 2, 1, 0, 1, 2
0, 1, 1, 0, 1, 0, 0, 0, 1, 1, 0, 0, 2, 1, 0, 0, 2
0, 0, 1, 0, 0, 1, 1, 1, 1, 0, 0, 1, 0, 1, 0, 1, 4
0, 0, 1, 0, 0, 1, 1, 1, 1, 0, 0, 1, 0, 1, 0, 0, 4
0, 0, 1, 0, 0, 0, 1, 1, 1, 1, 1, 0, 0, 1, 0, 0, 3
1, 0, 1, 1, 0, 1, 1, 0, 1, 1, 0, 0, 4, 1, 0, 1, 1
1, 0, 0, 1, 0, 0, 1, 1, 1, 1, 0, 0, 4, 1, 0, 1, 1
1, 0, 0, 1, 0, 0, 0, 1, 1, 1, 0, 0, 4, 1, 1, 1, 1
0, 0, 0, 1, 0, 1, 1, 1, 1, 1, 0, 1, 0, 1, 0, 1, 1
1, 0, 0, 1, 0, 0, 1, 1, 1, 1, 0, 0, 4, 1, 0, 1, 1
1, 0, 0, 1, 0, 0, 1, 1, 1, 1, 0, 0, 4, 1, 1, 1, 1
1, 0, 0, 1, 0, 0, 1, 1, 1, 1, 0, 0, 4, 1, 0, 1, 1
1, 0, 0, 1, 0, 0, 0, 1, 1, 1, 0, 0, 4, 1, 1, 1, 1
0, 1, 1, 0, 0, 0, 1, 0, 1, 1, 0, 0, 2, 1, 0, 1, 2
0, 0, 0, 0, 0, 0, 1, 0, 0, 1, 1, 0, 8, 1, 0, 0, 7
0, 0, 1, 0, 0, 1, 0, 1, 1, 0, 0, 1, 0, 1, 0, 0, 4
1, 0, 0, 1, 0, 1, 1, 1, 1, 1, 0, 1, 0, 0, 0, 1, 1
1, 0, 0, 1, 0, 1, 1, 1, 1, 1, 0, 1, 2, 1, 0, 1, 1
0, 0, 0, 0, 0, 1, 1, 1, 1, 0, 1, 0, 0, 1, 0, 0, 3
0, 0, 1, 0, 0, 1, 1, 0, 0, 0, 1, 0, 0, 0, 0, 0, 7
0, 1, 1, 0, 1, 1, 1, 0, 1, 1, 0, 0, 2, 1, 0, 0, 2
0, 1, 1, 0, 1, 1, 1, 0, 1, 1, 0, 0, 2, 1, 0, 0, 2
0, 0, 1, 0, 0, 0, 1, 1, 1, 1, 0, 0, 0, 1, 0, 0, 3
0, 0, 1, 0, 0, 0, 0, 0, 0, 1, 0, 0, 0, 0, 0, 0, 7
0, 0, 1, 0, 0, 1, 0, 1, 1, 0, 0, 1, 0, 1, 0, 0, 4
0, 1, 1, 0, 1, 0, 0, 0, 1, 1, 0, 0, 2, 1, 0, 0, 2
1, 0, 0, 1, 0, 0, 0, 1, 1, 1, 0, 0, 2, 1, 0, 0, 1
0, 0, 1, 0, 0, 1, 1, 1, 1, 0, 1, 1, 0, 1, 0, 1, 4
0, 1, 1, 0, 1, 1, 0, 0, 1, 1, 0, 0, 2, 1, 0, 1, 2
0, 0, 1, 0, 0, 0, 0, 0, 0, 1, 0, 0, 6, 0, 0, 0, 6
0, 0, 1, 0, 0, 1, 0, 1, 1, 1, 0, 0, 4, 0, 0, 0, 5
0, 0, 1, 0, 0, 0, 0, 0, 1, 1, 0, 0, 4, 1, 0, 1, 3
0, 0, 1, 0, 0, 0, 1, 1, 1, 1, 0, 0, 4, 1, 0, 0, 3
0, 0, 1, 0, 0, 1, 1, 1, 1, 0, 0, 1, 0, 1, 0, 1, 4
1, 0, 0, 1, 1, 0, 0, 1, 1, 1, 0, 0, 2, 1, 0, 0, 1
1, 0, 0, 1, 0, 0, 0, 1, 1, 1, 0, 0, 4, 1, 0, 0, 1
0, 1, 1, 0, 1, 0, 1, 0, 1, 1, 0, 0, 2, 1, 0, 1, 2
1, 0, 0, 1, 0, 0, 0, 1, 1, 1, 0, 0, 2, 1, 0, 1, 1
1, 0, 1, 0, 1, 0, 0, 0, 0, 1, 1, 0, 6, 0, 0, 0, 6
1, 0, 0, 1, 0, 0, 1, 1, 1, 1, 0, 0, 4, 1, 0, 1, 1
0, 0, 1, 0, 0, 0, 0, 0, 0, 1, 0, 0, 0, 0, 0, 0, 7
0, 1, 1, 0, 1, 0, 0, 0, 1, 1, 0, 0, 2, 1, 0, 0, 2
